7
12
50
HHHHHHHHHHHHHHHHHHHHHHHHHHHHHHHHHHHHHHHHHHHHHHHHHH
H--------R---------RRR----R------W---------------H
H--D-----D---------RRR---- ------W---D----R------H
H------------------------- ------W--------D------H
H--R------R----D----W----R ------W------XX  -----H
H--D------DDDD-----------  ---WWWW---------------H
H-----------------S------  ------W----D-----D----H
HWW----------------------RC------W---------------H
H---------------   ------- -----WW-----X --------H
H--               -------  ----------------------H
H----W-----------C------ RX-----E--------DD------H
HHHHHHHHHHHHHHHHHHHHHHHHHHHHHHHHHHHHHHHHHHHHHHHHHH

