25
24
70
HHHHHHHHHHHHHHHHHHHHHHHHHHHHHHHHHHHHHHHHHHHHHHHHHHHHHHHHHHHHHHHHHHHHHH
H-----------------------------------------------------------D--------H
H----S---------R-------------------R---------------------------------H
H-------------DR------------------DD------------------------D--------H
H--------------RD----------------------------X----R------------------H
H--------------R-------------------WD-------- --RRR------------------H
H--------------------  C----------WW--------- ----R----------D-------H
H-------DD--------W-------------------------- -----------------------H
H-----------------W--DDD--------------------- ----R------------------H
H-----------------W-----------------D-------- -----------------------H
H-------------------------------------------- --------------RR-------H
HHHHHHHHHHHHHHHHHHHHHHHHHHHHHHHHHHHHHHHHHHHHHHHHHHHHHHHH---------HHHHH
H--------------------------------------------------------------------H
H--D------------RRRR-----------X-------RRRRRRRR----------------------H
H--D------------RD-R----------- ---------D---------------------------H
H--D------------R--R---------      ------D---------------R-----------H
H---------------R--R----------- ---------D--DDD----------------------H
H-------DD--------------------- ----------------  -------------------H
H----------------------------------------------  --------R-----------H
H---------------------------------------------  ------D--------------H
H-----------------D-----DWWWWWWWWD---------C      -------------------H
H--------------------------------------------------------------------H
H--------------------------------------D----------------------------EH
HHHHHHHHHHHHHHHHHHHHHHHHHHHHHHHHHHHHHHHHHHHHHHHHHHHHHHHHHHHHHHHHHHHHHH
