7
12
50
HHHHHHHHHHHHHHHHHHHHHHHHHHHHHHHHHHHHHHHHHHHHHHHHHH
H--------R---------RRR----R------W---------------H
H--------D---------RRR---- ------W---D----R------H
H------------------------- ------W--------D------H
H-------------------W----R ------W---------------H
H---------DDDD-----------  ---WWWW---------------H
H-----------------S------  ------W----D-----D----H
HWW----------------------RC------W---------------H
H---------------   ------- -----WW---------------H
H---------------  -------  ----------------------H
H----W-----------C------ RX--------------DD----E-H
HHHHHHHHHHHHHHHHHHHHHHHHHHHHHHHHHHHHHHHHHHHHHHHHHH

