10
24
70
HHHHHHHHHHHHHHHHHHHHHHHHHHHHHHHHHHHHHHHHHHHHHHHHHHHHHHHHHHHHHHHHHHHHHH
H-----------------------------------------------------------D--------H
H----S---------R-------------------R---------------------------------H
H-------------DR------------------DD------------------------D--------H
H--------------RD---------------------------------R------------------H
H--------------R-------------------WD-----------RRR------------------H
H---------------------------------WW--------------R----------D-------H
H-------DD--------W--------------------------------------------------H
H-----------------W--DDD--------------------------R------------------H
H-----------------W-----------------D--------------------------------H
H-----------------------------------------------------------RR-------H
HHHHHHHHHHHHHHHHHHHHHHHHHHHHHHHHHHHHHHHHHHHHHHHHHHHHHHHH---------HHHHH
H--------------------------------------------------------------------H
H---------------RRRR-------------------RRRRRRRR----------------------H
H---------------RD-R---------------------D---------------------------H
H---------------R--R---------------------D---------------R-----------H
H---------------R--R---------------------D--DDD----------------------H
H--------------------------------------------------------------------H
H--------------------------------------------------------R-----------H
H--------------------------------------------------------------------H
H-----------------D--------------------------------------------------H
H--------------------------------------------------------------------H
H--------------------------------------D----------------------------EH
HHHHHHHHHHHHHHHHHHHHHHHHHHHHHHHHHHHHHHHHHHHHHHHHHHHHHHHHHHHHHHHHHHHHHH
